12 12
1 1 1 1 1 0 0 1 1 1 1 1
1 1 1 1 1 0 0 0 0 0 0 1
1 1 1 1 0 0 0 1 1 0 0 1
0 2 2 1 0 1 0 1 1 0 1 1
0 0 0 0 0 3 0 0 1 3 1 1
1 0 0 1 0 1 0 0 0 0 1 1
1 1 1 1 0 0 0 1 1 3 1 1
1 1 1 1 1 1 1 1 1 0 0 1
1 1 1 1 2 0 0 0 0 0 0 1
1 1 1 1 1 1 1 1 1 1 1 1
1 1 1 1 1 1 1 1 1 1 1 1
1 1 1 1 1 1 1 1 1 1 1 1
5 0
5 7
1 1 1 1 1 1 1
1 1 1 1 1 1 1
1 0 3 0 0 2 1
1 1 1 1 1 1 1
1 1 1 1 1 1 1
1 2
7 18
1 1 1 1 1 1 1 1 1 1 1 1 1 1 1 1 1 1
1 1 0 0 0 2 1 1 1 1 1 0 0 1 1 1 0 1
1 1 0 0 0 1 1 1 1 1 1 0 0 1 1 0 0 1
1 1 1 0 0 1 1 0 0 3 0 0 0 1 1 0 0 1
1 1 1 1 0 0 0 0 0 0 0 0 0 0 1 1 1 1
1 1 1 1 0 0 0 0 0 0 0 0 0 0 1 1 1 1
1 1 1 1 1 1 1 1 1 1 1 1 1 1 1 1 1 1
7 4
10 9
1 1 1 1 1 1 2 2 0
1 0 0 0 0 1 0 0 0
1 0 3 0 0 3 0 0 0
1 0 0 0 0 1 1 0 0
1 0 0 0 0 0 0 0 0
1 0 0 0 0 0 0 1 1
1 0 0 0 0 0 0 2 1
1 0 0 3 0 0 1 1 1
1 0 0 0 0 0 1 1 1
1 1 1 1 1 1 1 1 1
2 5
10 10
1 1 1 1 2 0 0 0 0 0
1 0 0 1 0 0 0 0 0 0
1 3 0 1 1 1 1 0 0 0
0 0 0 0 0 3 0 0 1 0
0 0 0 0 1 1 1 0 1 0
0 0 0 0 0 0 0 0 3 0
1 1 0 0 0 2 0 0 0 0
1 1 0 0 0 1 1 0 0 0
1 1 1 1 1 1 0 0 0 0
1 1 2 0 0 0 0 0 0 0
2 3
